15 10
WWWWWWWWWWWWWWW
W.............W
W.............W
W.............W
P........D....E
W.............W
W.............W
W.............W
W.............W
WWWWWWWWWWWWWWW

