15 10
WWWWWPWWWWWWWWW
W..W..W..M..W.W
W..WMW...W..M.W
W..M.W.WWWWWW.W
w.WW.WDW....WME
W.W.WWEW..WMM..
W.W....M..W.WWW
W.WMW..WWWWWW.W
W...W..M.......
W.WWW..WWWWWWWW
