15 10
WPWWWWWWWWWWWWW
W.W...DW......W
W.WW.WWW.WW..DW
W.......M.WMWWW
W.WWWWWW.WW...E
W.W.....DW..WWW
W.WD.W.WWW..WDW
W.WW.W...WMWW.W
WD...WDW......W
WWWWWWWWWWWWWWW
