15 10
WWWWWWWWWWWWWWW
WD...........DW
W.............W
WWWWW.........W
P...M....D....W
WWWWW.........W
W.........WWWWW
W.........W..DW
WD........M...W
WWWWWWWWWWWWEWW


